00000000000000000000
0000000000000000000G
00000000000001111111
00000001110000000000
00000000000011000000
00111100000000000000
00000000011110000000
00000000000000011000
00011110000000000000
00000000111111000000
01100000000000000000
00000001111000001111
P0000000000000000000
11111111111111111111